WWWWWWWWWWWWWWWWWWWWWWWWWWWWWWWWWWWWWWWWWWWWWWWWWWWWWWWWWWWW
WWWWWWWWWWWWWWWWWWWWWWWWWWWWWWWWWWWWWWWWWWWWWWWWWWWWWWWWWWWW
WWWWWWWWWWWWWWWWWWWWWWWWWWWWWWWWWWWWWWWWWWWWWWWWWWWWWWWWWWWW
WWWWWWWWWWWWWWWWWWWWWWWWWWWWWWWWWWWWWWWWWWWWWWWWWWWWWWWWWWWW
WM                                              M          W
W WWWWWWWWWWWWWWWWWWW WWWWWWWWWWWWWWWW WWWWWWWWWWWWWWWWWWW W
W WWWWWWWWWWWWWWWWWWW    R             WWWWWWWWWWWWWWWWWWW W
W WWWWWWWWWWWWWWWWWWW                  WWWWWWWWWWWWWWWWWWW W
W WWWWWWWWWWWWWWWWWWW                  WWWWWWWWWWWWWWWWWWW W
W                                                          W
W                                                          W
WWWWWWWWWWWWWWWWWWWWW                  WWWWWWWWWWWWWWWWWWW W
WWWWWWWWWWWWWWWWWWWWW                  WWWWWWWWWWWWWWWWWWW W
WWWWWWWWWWWWWWWWWWWWWWWWWWWW W WWWWWWWWWWWWWWWWWWWWWWWWWWW W
W       M                    S                             W
W WWWWWWWWWWWWWWWWWWWWWWWWWW W WWWWWWWWWWWWWWWWWWWWWWWWWWWWW
W WWWWWWWWWWWWWWWWWWW        J         WWWWWWWWWWWWWWWWWWWWW
W WWWWWWWWWWWWWWWWWWW  R               WWWWWWWWWWWWWWWWWWWWW
W WWWWWWWWWWWWWWWWWWW WWWHWWWWWWWHWWWWWWWWWWWWWWWWWWWWWWWWWW
W          R        W                  H    R              W
W                   H                  W                   W
W WWWWWWWWWWWWWWWWWWW                  WWWWWWWWWWWWWWWWWWW W
W WWWWWWWWWWWWWWWWWWW                  WWWWWWWWWWWWWWWWWWW W
W WWWWWWWWWWWWWWWWWWW                  WWWWWWWWWWWWWWWWWWW W
W WWWWWWWWWWWWWWWWWWW WWWWWWWWWWWWWWWW WWWWWWWWWWWWWWWWWWW W
W                                                         MW
WWWWWWWWWWWWWWWWWWWWWWWWWWWWWWWWWWWWWWWWWWWWWWWWWWWWWWWWWWWW
WWWWWWWWWWWWWWWWWWWWWWWWWWWWWWWWWWWWWWWWWWWWWWWWWWWWWWWWWWWW
WWWWWWWWWWWWWWWWWWWWWWWWWWWWWWWWWWWWWWWWWWWWWWWWWWWWWWWWWWWW
WWWWWWWWWWWWWWWWWWWWWWWWWWWWWWWWWWWWWWWWWWWWWWWWWWWWWWWWWWWW