WWWWWWWWWWWWWWWWWWWWWWWWWWWWWWWWWWWWWWWWWWWWWWWWWWWWWWWWWWWW
W                            W S                           W
W                            W W                           W
W             R              HMW              R            W
W                   J        W H                           W
W                            W W                           W
WWWWWWWWWWWWWWWWWHWWWWWWWWWWWW WWWWWWWWWWWWWWWWWWWWWWWWWWWWW
W                              H                           W
W WWWWWWWWWWWWWWWWWWWWWWWWWWWWWWWWWWWWWWWWWWWWWHWWWWWWWWWWWW
W                                      W                   W
WWWWWWWWWWWWWWWWWHWWWWWWWWWWWWWWWWWWWW W                   W
W                                    H W                   W
W                                    W WWWWWWWWHWWWWWWWWWWWW
W                R                   WMW                   W
W                                    W W                   W
W                                    W W                   W
WWWWWWWWWWWWWWWWWWWWWWWWWHWWWWWWWWWWWW W                   W
W                                    H W                   W
W                                    W W    WWWWWWWW       W
W                            R       W H    W  R   W       W
W                                    W W    WHWWWWHW       W
WWWWWWWWWWWWWWWWHWWWWWWWWWWWWWWWWWWWWW W                   W
W                  M                   W                   W
W WWWWWWWWWWWWWWWWWWWWWWWWWWWWWWWWWWWWWW                   W
W                                      W                   W
WWWWWWWWWWWWWWWWHWWWWWWWWWWWWWWWWWWWWW W                   W
W            R                       WMW                   W
WWWWWWWWWWWWWWWWWWWWWWWWWWWWHWWWWWWWWW WWWWWWWWWWWWWWWWWWWWW
W                          R         W                 M   W
WWWWWWWWWWWWWWWWWWWWWWWWWWWWWWWWWWWWWWWWWWWWWWWWWWWWWWWWWWWW