WWWWWWWWWWWWWWWWWWWWWWWWWWWWWWSSWWWWWWWWWWWWWWWWWWWWWWWWWWWW
W                                                          W
W                                                          W
W                                                          W
W                                                          W
WWWWWWWWWWWWWWWWWWWWWWWWWWWWWWWWWWWWWWWWWWWWW              W
W                                                          W
W                                                          W
W                                                          W
W                                                          W
W                                                          W
W              WWWWWWWWWWWWWWWWWWWWWWWWWWWWWWWWWWWWWWWWWWWWW
W                                                          W
W                                                          W
W                                                          W
W                                                          W
W                                                          W
WWWWWWWWWWWWWWWWWWWWWWWWWWWWWWWWWWWWWWWWWWWWW              W
W                                                          W
W                                                          W
W                                                          W
W                                                          W
W                                                          W
W              WWWWWWWWWWWWWWWWWWWWWWWWWWWWWWWWWWWWWWWWWWWWW
W                                                          W
W                                                          W
W                                                          W
W                              J                           W
W                                                          W
WWWWWWWWWWWWWWWWWWWWWWWWWWWWWWWWWWWWWWWWWWWWWWWWWWWWWWWWWWWW