WWWWWWWWWWWWWWWWWWWWWWWWWWWWWWWWWWWWWWWWWWWWWWWWWWWWWWWWWWWW
W                                                          W
W                                                          W
W                                                   O      W
W                                                          W
W                                                          W
W                                                          W
W                                                          W
W                                                          W
W                                                          W
W    M    M               M            O              S    W
W                                                          W
W                                                          W
W                                                          W
WO                                                         W
W                                                          W
W                 M                                        W
W                                                          W
WO                                                         W
W                                                          W
W                R                                         W
W                         M                                W
W                                                          W
W            R                                             W
W                      R                           M       W
W                                                          W
W            R                                             W
W                     J                                    W
W                                                          W
WWWWWWWWWWWWWWWWWWWWWWWWWWWWWWWWWWWWWWWWWWWWWWWWWWWWWWWWWWWW