WWWWWWWWWWWWWWWWWWWWWWWWWWWWWWWWWWWWWWWWWWWWWWWWWWWWWWWWWWWW
WWWWWWWWWWWWWWWWWWWWWWWWWWWWWWWWWWWWWWWWWWWWWWWWWWWWWWWWWWWW
WWWWWWWWWWWWWWWWWWWWWWWWWWWWWWWWWWWWWWWWWWWWWWWWWWWWWWWWWWWW
WWWWWWWWWWWWWWWWWWWWWWWWWWWWWWWWWWWWWWWWWWWWWWWWWWWWWWWWWWWW
WM                 M                                       W
W WWWWWWWWWWWWWWWWWWW WWWWWWWWWWWWWWWW WWWWWWWWWWWWWWWWWWW W
W WWWWWWWWWWWWWWWWWWW                  WWWWWWWWWWWWWWWWWWW W
W WWWWWWWWWWWWWWWWWWW                  WWWWWWWWWWWWWWWWWWW W
W WWWWWWWWWWWWWWWWWWW                  WWWWWWWWWWWWWWWWWWW W
W         R                                 R              W
W                            R                  R          W
W WWWWWWWWWWWWWWWWWWW                  WWWWWWWWWWWWWWWWWWW W
WMWWWWWWWWWWWWWWWWWWW  R     H         WWWWWWWWWWWWWWWWWWW W
WWWWWWWWWWWWWWWWWWWWWHHWWWWWWWWWWWWWWHHWWWWWWWWWWWWWWWWWWW W
W                            S                             W
W WWWWWWWWWWWWWWWWWWWHHWWWWWWWWWWWWWWHHWWWWWWWWWWWWWWWWWWWWW
W WWWWWWWWWWWWWWWWWWW        H         WWWWWWWWWWWWWWWWWWW W
W WWWWWWWWWWWWWWWWWWW  R               WWWWWWWWWWWWWWWWWWW W
W WWWWWWWWWWWWWWWWWWW        J         WWWWWWWWWWWWWWWWWWW W
W         R                                 R              W
W            R               R                             W
W WWWWWWWWWWWWWWWWWWW                  WWWWWWWWWWWWWWWWWWW W
W WWWWWWWWWWWWWWWWWWW                  WWWWWWWWWWWWWWWWWWW W
W WWWWWWWWWWWWWWWWWWW                  WWWWWWWWWWWWWWWWWWW W
W WWWWWWWWWWWWWWWWWWW WWWWWWWWWWWWWWWW WWWWWWWWWWWWWWWWWWW W
W                                                         MW
WWWWWWWWWWWWWWWWWWWWWWWWWWWWWWWWWWWWWWWWWWWWWWWWWWWWWWWWWWWW
WWWWWWWWWWWWWWWWWWWWWWWWWWWWWWWWWWWWWWWWWWWWWWWWWWWWWWWWWWWW
WWWWWWWWWWWWWWWWWWWWWWWWWWWWWWWWWWWWWWWWWWWWWWWWWWWWWWWWWWWW
WWWWWWWWWWWWWWWWWWWWWWWWWWWWWWWWWWWWWWWWWWWWWWWWWWWWWWWWWWWW