WWWWWWWWWWWWWWWWWWWWWWWWWWWWWWWWWWWWWWWWWWWWWWWWWWWWWWWWWWWW
W      M                  M                   M            W
W WWWWWWWWWWWWWWWWWWWWWWWWWWWWWHWWWWWWWWWWWWWWWWWWWWWWWWWWHW
W W                W            W                          W
W W                W            W            R             W
WMW       R        W            W                          W
W W                W            W                          W
W W                W            W                          W
W W                H            H                          W
W W                WWWWWWWWWWWWWW                          W
W W                             W                          W
W W                             W                          W
W W                             W                          W
W W                             W                          W
W W                             W                          W
W W                             W                          W
WMW                             W                          W
W W                             W                          W
W W        R                    W                          W
W W                             W                          W
W W                             W                          W
W W       WWWWWWWWWWWWWWWWWWWWWHWWWWWWWWWWWWWWWWWWWW       W
W W       W                                  R     W       W
W W       W                                        W       W
W W       W       R                                W       W
W W       W                                       WW       W
W H       WWWWWWWWWWWWWWWWWWWWWWWWWWWWWWWWWWWWWWWW H      WW
W W                           W                    W       W
W W             J             W          R         W       W
WSWWWWWWWWWWWWWWWWWWWWWWWWWWWWWWWWWWWWWWWWWWWWWWWWWWWWWWWWWW