WWWWWWWWWWWWWWWWWWWWWWWWWWWWWSSSWWWWWWWWWWWWWWWWWWWWWWWWWWWW
W                                                          W
W                                                          W
W                            J                             W
W                                                          W
WWWWWWWWWWWWWWWWWWWWWWWWWWWWWWWWWWWWWWWWWWWWW              W
W                                                          W
W                                       R                  W
W                                                          W
W                        M                                 W
W                                                          W
W              WWWWWWWWWWWWWWWWWWWWWWWWWWWWWWWWWWWWWWWWWWWWW
W                                                          W
W                                                          W
W                            M                R            W
W                                                          W
W                                                          W
WWWWWWWWWWWWWWWWWWWWWWWWWWWWWWWWWWWWWWWWWWWWW              W
W                                                          W
W                                                          W
W     R                                                    W
W                           M                              W
W                                                          W
W              WWWWWWWWWWWWWWWWWWWWWWWWWWWWWWWWWWWWWWWWWWWWW
W                                                          W
W                                                          W
W                                                          W
W                              M                      R    W
W                                                          W
WWWWWWWWWWWWWWWWWWWWWWWWWWWWWWWWWWWWWWWWWWWWWWWWWWWWWWWWWWWW