WWWWWWWWWWWWWWWWWWWWWWWWWWWWWWWWWWWWWWWWWWWWWWWWWWWWWWWWWWWW
W   H                                           W          W
W   W WWWWWWWWWWWWWWWWHWWWWWWWWWWWWWWWWWWWWWWWW W    R     W
W   W H                                       W W          W
W   W W                   R                   H H    J     W
W   W W                                       W W          W
W R W WWWHWWWWWWWWWWWWWWWWWWWWWWWWWHWWWWWWWWWWW W          W
W   W W     W                                   WWWWWWWHWWWW
W   H W     W WWWWWWWWWWWWWWWWWWWWWWWWWWWWWWWWWWWWWWWWWWWWWW
W   W H     W W                                            W
W   W W     W WWWWWWWWWWWWWWWWWWWWWWWWWWWWWWWWWWWWWWWWWHWWWW
W   W W     W                                    W         W
W   W WWWHWWWWWWWWWWWWWWWWWWWWWWWWWWWWWWWWWWWWWW W         W
W   W W                WWWWWWWWWWWWWWWWWWWWWWWWW W     R   W
W   W W     R          H                         W         W
W   W W                WSWWWWWWWWWWWWWWWWWWWWWW  W         W
W   W WWWWWWWWWWWWWWWWWWW                      WWWWWWWWWWWWW
W   W W                                                    W
W   WMW              WWWWWWWWWWWWW                         W
W   W W              W   R R R   W                         W
W   W W              W           W                         W
W   W W              WWWWWWHWWWWWW                         W
W   W W                                                    W
W   W W                                                    W
W   W WWWWHWWWWWWWWWWWWWWWWWWWWWWWWWWWWWWWWWWWWWWWWWWWWWWWWW
W   W                     M              M        M     WWWW
WWWWWWWWWWWWWWWWWWWWWWWWWWWWWWWWWWWWWWWWWWWWWWWWWWWWWWW WWWW
W                                                     W WWWW
W                                                     WMWWWW
WWWWWWWWWWWWWWWWWWWWWWWWWWWWWWWWWWWWWWWWWWWWWWWWWWWWWWWWWWWW