WWWWWWWWWWWWWWWWWWWWWWWWWWWWWWWWWWWWWWWWWWWWWWWWWWWWWWWWWWWW
W             W    W               W      W         W      W
W             W    W               W      W         W      W
W         J   H    H     R         W      W         W      W
W             W    W               H      H   R     W      W
W             W    W               W      W         H      W
W             WWWWWWHWWWWWWWWHWWWWWWWW    W         W      W
W             W  W                   W    W         W      W
W             W  W WWWWWWWWWWHWWWWWW W    W         W      W
WWWWWWWWWWWWWHW  W W        R      W W    W         W      W
W                W W             W W W    W         W      W
W                W W             W W W    W         W      W
WWWWWWWWWWWWWWWWWW WWWWWWHWWWWWWWW W WWWWWWWWWWWWWWWWWWWWWWW
S                             M           W  WW   M    M   W
WWWWWWWWWWWWWWWWWWWWWWWWWWWWWWWWWWWWWWWWW WWWWW WWWWWWWWWWWW
W          W                            W W   W W          W
W          W                            W W   W W          W
W          W                            W W   W W          W
W          W                            W W   W W          W
W          W            WWWWWW          W W   W W          W
W          W            W  R W          W W   W W          W
W          W            WHWWHW          W W   W W          W
W     R    H                            W W   W W          W
W          W                            W W   W W          W
W          W                            W W   W W          W
W          W                            W W   W W          W
W          W                            W W   W W          W
W          W            R               W WWWWW W          W
W          W                            W   M   WR         W
WWWWWWWWWWWWWWWWWWWWWWWWWWWWWWWWWWWWWWWWWWWWWWWWWWWWWWWWWWWW