WWWWWWWWWWWWWWWWWWWWWWWWWWWWWWWWWWWWWWWWWWWWWWWWWWWWWWWWWWWW
W                                                          W
W                                                          W
W                                                   O      W
W                                                          W
W                                                          W
W                                                          W
W                                                          W
W                                                          W
W                                                          W
W   S                     M            O                   W
W                                                          W
W                                                          W
W                                                          W
WO                                                         W
W                                                          W
W                                                          W
W                                                          W
WO                                                         W
W                                                          W
W                                                          W
W                                                          W
W                                                          W
W                                                          W
W                                                          W
W                                                          W
W                                                          W
W                     J                                    W
W                                                          W
WWWWWWWWWWWWWWWWWWWWWWWWWWWWWWWWWWWWWWWWWWWWWWWWWWWWWWWWWWWW