WWWWWWWWWWWWWWWWWWWWWWWWWWWWWSSSWWWWWWWWWWWWWWWWWWWWWWWWWWWW
W                                                          W
W                                                          W
W                            J                             W
W                                                          W
WWWWWWWWWWWWWWWWWWWWWWWWWWWWWWWWWWWWWWWWWWWWW              W
W                                                          W
W                                                          W
W                                                          W
W                        M                                 W
W                                                          W
W              WWWWWWWWWWWWWWWWWWWWWWWWWWWWWWWWWWWWWWWWWWWWW
W                                                          W
W                                                          W
W                            M                             W
W                                                          W
W                                                          W
WWWWWWWWWWWWWWWWWWWWWWWWWWWWWWWWWWWWWWWWWWWWW              W
W                                                          W
W                                                          W
W                                                          W
W                           M                              W
W                                                          W
W              WWWWWWWWWWWWWWWWWWWWWWWWWWWWWWWWWWWWWWWWWWWWW
W                                                          W
W                                                          W
W                                                          W
W                              M                           W
W                                                          W
WWWWWWWWWWWWWWWWWWWWWWWWWWWWWWWWWWWWWWWWWWWWWWWWWWWWWWWWWWWW