WWWWWWWWWWWWWWWWWWWWWWWWWWWWWWWWWWWWWWWWWWWWWWWWWWWWWWWWWWWW
W                                                          W
W                                                          W
W      M                                                   W
W                                                          W
W                                                          W
W                                                          W
W                                                          W
W                               M            M             W
W                                                          W
W                                                          W
W                                                          W
W                                                          W
W                              M                           W
W                                                          W
W                                                          W
W                                                          W
W                                                          W
W                                                          W
W                                                          W
W                                   M                      W
W                                                          W
W                                   M                      W
W                                                          W
W                                                          W
W                                                          W
W                                                          W
W                     J                                    W
W                                                          W
WWWWWWWWWWWWWWWWWWWWWWWWWWWWWWWWWWWWWWWWWWWWWWWWWWWWWWWWWWWW