WWWWWWWWWWWWWWWWWWWWWWWWWWWWWWWWWWWWWWWWWWWWWWWWWWWWWWWWWWWW
W        M       M        M       M                        W
W   WWWWWWWWWWWWWWWWWWWWWWWWWWWWWWWWWWWWWWWWWWWWWWWWWWWWW  W
W   W                                                  W   W
W   W   WWWWWWWWWWWWWWWWWWWWWWWWWWWWWWWWWWWWWWWWWWWWW  W   W
W   W   W                                          W   W   W
W   W   W   WWWWWWWWWWWWWWWWWWWWWWWWWWWWWWWWWWWWW  W   W   W
W   W   W   W                                  W  W   W    W
W   W   W   W   WWWWWWWWWWWWWWWWWWWWWWWWWWWWW  W  W   W    W
W   W   W   W   W                          W  W  W   W     W
W   W   W   W   W   WWWWWWWWWWWWWWWWWWWWW  W  W  W   W     W
W   W   W   W   W   W                  W  W  W  W   W      W
W   W   W   W   W   W   WWWWWWWWWWWWW  W  W  W  W   W      W
W   W   W   W   W   W   W          W  W  W  W  W   W       W
W   W   W   W   W   W   W   WWWWW  W  W  W  W  W   W       W
W   W   W   W   W   W   W   W    W  W  W  W  W  W   W      W
W   W   W   W   W   W   W   W    W  W  W  W  W  W   W      W
W   W   W   W   W   W   W   W    W  W  W  W  W  W   W      W
W   W   W   W   W   W   W   W    W  W  W  W  W  W   W      W
W   W   W   W   W   W   W   W    W  W  W  W  W  W   W      W
W   W   W   W   W   W   W   W    W  W  W  W  W  W   W      W
W   W   W   W   W   W   W   W    W  W  W  W  W  W   W      W
W   W   W   W   W   W   W   W    W  W  W  W  W  W   W      W
W   W   W   W   W   W   W   W    W  W  W  W  W  W   W      W
W   W   W   W   W   W   W   W    W  W  W  W  W  W   W      W
W                               J                          W
WWWWWWWWWWWWWWWWWWWWWWWWWWWWWWWWWWWWWWWWWWWWWWWWWWWWWWWWWWWW