WWWWWWWWWWWWWWWWWWWWWWWWWWWWWWSWWWWWWWWWWWWWWWWWWWWWWWWWWWWW
W                                                          W
W                                                          W
W                            J                             W
W                                                          W
WWWWWWWWWWWWWWHWWWWWWWWWWWWWWWWWWWWWWWWWWWWWW     R        W
W                                                          W
W                                       R                  W
W                                                          W
W                        M                                 W
W                                                          W
W      R       WWWWWWWWWWWWWWWWWWWWWWWWWWHWWWWWWWWWWWWWWWWWW
W                                                          W
W                                                          W
W                            M                R            W
W                                                          W
W                                                          W
WWWWWWWWWWWWWWWHWWWWWWWWWWWWWWWWWWWWWWWWWWWWW              W
W                                                          W
W                                                          W
W     R                                                    W
W                           M                              W
W                                                          W
W              WWWWWWWWWWWWWWWWWWWWWHWWWWWWWWWWWWWWWWWWWWWWW
W                                                          W
W                                                          W
W                                                          W
W                              M                      R    W
W                                                          W
WWWWWWWWWWWWWWWWWWWWWWWWWWWWWWWWWWWWWWWWWWWWWWWWWWWWWWWWWWWW